5
5
0 2 2 2 4 
3 2 4 1 4 
1 4 4 1 1 
1 1 2 2 3 
2 1 4 1 3 
